NO ./textures/meow1.png
SO ./textures/meow2.png
WE ./textures/meow3.png
EA ./textures/meow4.png

F 220,100,0
C 225,30,0




        1111111111111111111111  
        1000000000110000000001
        1011000001110000000001
        1001000000000000000001
111111111011000001110000000001
100000000011000001110111110111
11110111111111011100000010001    
11110111111111011101010010001
11000000110101011100000010001
10000000000000001100000010001
10000000000000001101010010001
11000001110101011111011110N01
1111011111110101 101111010001
111111 111111111 111111111111
111111 111111111 111111111111
111111 111111111 111111111111
