NO ./textures/N.png
SO ./textures/S.png
WE ./textures/W.png
EA ./textures/E.png
K ./textures/Key1.png
K ./textures/Key2.png
K ./textures/Key3.png
K ./textures/Key4.png
K ./textures/Key5.png
D ./textures/Key5.png

C 15,15,43
F 30,30,30



1111111111111111
1K0W0000000000K1
1000001D10000001
1000000000000001
1000000000000001
1000000000000001
1000000000000001
1K000000000000K1
1111111111111111
